   ###
###  ###
######
  ######
########
   ####
#####
#######